7 8
R R D R R R R D
R L D U R D L L
D L L U L D R D
D R R D U D U D
D U D D U R U D
D U D D U D L L
R U U R U R R D
