7 8
RRDRRRRD
RLDURDLL
DLLULDRD
DRRDUDUD
DUDDURUD
DUDDUDLL
RUURURRD
